##################################
#     B                          #
#            #         #         #
##############         ###########
##############         ###########
##############         ###########
##############         ###########
##############         ###########
#            #         ###########
#            #         #         #
#            #                   #
#            #                   #
#            #         ###########
#      A               ###########
##############         ###########
##############         ###########
##############         ###########
##################################